0,0,0,0,0,0,0,0,0,0,0,0,0,0,0,0,0,0,0,0,0,0,0,0
0,1,1,1,1,1,1,1,1,1,3,1,3,1,1,1,1,1,1,1,1,1,1,0
0,1,2,3,1,1,1,1,1,1,3,1,3,1,1,1,1,1,1,1,3,2,1,0
0,1,3,3,1,1,1,1,1,1,3,1,3,1,1,1,1,1,1,1,3,3,1,0
0,1,1,1,4,1,1,1,1,1,3,3,3,1,1,1,1,1,1,6,1,1,1,0
0,1,1,1,1,4,1,1,1,1,1,1,1,1,1,1,1,1,6,1,1,1,1,0
0,1,1,1,1,1,4,1,1,1,1,1,1,1,1,1,1,6,1,1,1,1,1,0
0,1,1,1,1,1,1,4,1,1,1,1,1,1,1,1,6,1,1,1,1,1,1,0
0,1,1,1,1,1,1,1,4,1,1,1,1,1,1,6,1,1,1,1,1,1,1,0
0,1,1,1,1,1,1,1,1,1,1,1,1,1,1,1,1,1,1,1,1,1,1,0
0,1,3,1,1,1,1,1,1,5,5,5,5,5,1,1,1,1,3,3,3,1,1,0
0,1,3,1,1,1,1,1,1,5,5,5,5,5,1,1,1,1,3,1,1,3,1,0
0,1,3,1,1,1,1,1,1,5,5,5,5,5,1,1,1,1,3,3,3,1,1,0
0,1,3,1,1,1,1,1,1,5,5,5,5,5,1,1,1,1,3,1,3,1,1,0
0,1,3,3,3,1,1,1,1,5,5,5,5,5,1,1,1,1,3,1,1,3,1,0
0,1,1,1,1,1,1,1,1,1,1,1,1,1,1,4,1,1,1,1,1,1,1,0
0,1,1,1,1,1,1,6,1,1,1,1,1,1,1,1,4,1,1,1,1,1,1,0
0,1,1,1,1,1,6,1,1,1,1,1,1,1,1,1,1,4,1,1,1,1,1,0
0,1,1,1,1,6,1,1,1,1,1,1,1,1,1,1,1,1,4,1,1,1,1,0
0,1,1,1,6,1,1,1,1,1,3,3,1,1,1,1,1,1,1,4,1,1,1,0
0,1,3,3,1,1,1,1,1,1,3,1,3,1,1,1,1,1,1,1,3,3,1,0
0,1,2,3,1,1,1,1,1,1,3,1,3,1,1,1,1,1,1,1,3,2,1,0
0,1,1,1,1,1,1,1,1,1,3,3,1,1,1,1,1,1,1,1,1,1,1,0
0,0,0,0,0,0,0,0,0,0,0,0,0,0,0,0,0,0,0,0,0,0,0,0
